#################
#   #Z  #      Z#
### ### # ### ###
#D#   # #   #   #
# ### # ### ### #
#  D# #      D# #
# ### # ####### #
# #   # # #     #
# # ### # # ### #
# #   #   # #Z  #
# ### ### # #####
#     #P  #     #
# ############# #
#   #     #   # #
### ### # # # # #
#       #   #   #
#################
