#####
#  Z#
# ###
#  P#
#####
