########
#      #
#### # #
#    # #
# ##D# #
# ####Z#
#    P##
########